R 700 700


NO ./wall_n.xpm

SO ./wall_s.xpm
WE ./wall_w.xpm

EA ./wall_e.xpm

S ./path_to_the_sprite_texture
F 204, 204,255
C 255,204,255

1111111111
1110100011
1010000001
1110001001
1000011111
1000111101
1001011101
1010111101
1001000001
1111111111