R 500 500
NO ./wall_n.xpm
SO ./wall_s.xpm
WE ./wall_w.xpm

EA ./wall_e.xpm

S ./path_to_the_sprite_texture
F 204,204,255s
C 255,204,255

11111 1111
1110100011
1 10000001
1110001001
1000010001
1000100001
1001000001
1010111001
1001000001
1         